凹甲陆龟	aojialugui	ajlg
八色鸫科	basedongke	bsdk
白唇鹿	baichunlu	bcl
白额雁	baieyan	bey
白腹黑啄木鸟	baifuheizhuomuniao	bfhzmn
白腹军舰鸟	baifujunjianniao	bfjjn
白冠长尾雉	baiguanchangweizhi	bgcwz
白鹳	baiguan	bg
白鹤	baihe	bh
白鹮	baihuan	bh
白鱀豚	baijitun	bjt
白肩雕	baijiandiao	bjd
白颈长尾雉	baijingchangweizhi	bjcwz
白琵鹭	baipilu	bpl
白头鹤	baitouhe	bth
白尾海雕	baiweihaidiao	bwhd
白鹇	baixian	bx
白枕鹤	baizhenhe	bzh
斑林狸	banlinli	bll
斑羚	banling	bl
斑尾林鸽	banweilinge	bwlg
斑尾榛鸡	banweizhenji	bwzj
鸨	bao	b
豹	bao	b
北山羊	beishanyang	bsy
彩鹳	caiguan	cg
彩鹮	caihuan	ch
藏羚	cangling	cl
藏马鸡	cangmaji	cmj
藏酋猴	cangqiuhou	cqh
藏原羚	cangyuanling	cyl
草原斑猫	caoyuanbanmao	cybm
豺	chai	c
橙胸咬鹃	chengxiongyaojuan	cxyj
赤斑羚	chibanling	cbl
赤颈鹤	chijinghe	cjh
赤颈??	chijingpiti	cjpt
穿山甲	chuanshanjia	csj
丛林猫	conglinmao	clm
大壁虎	dabihu	dbh
大凉疣螈	daliangyouyuan	dlyy
大灵猫	dalingmao	dlm
大鲵	dani	dn
大熊猫	daxiongmao	dxm
玳瑁	daimao	dm
丹顶鹤	dandinghe	ddh
地龟	digui	dg
貂熊	diaoxiong	dx
短尾猴	duanweihou	dwh
短尾信天翁	duanweixintianweng	dwxtw
鹅喉羚	ehouling	ehl
鳄蜥	exi	ex
蜂猴	fenghou	fh
凤头雨燕	fengtouyuyan	ftyy
高鼻羚羊	gaobilingyang	gbly
贵州疣螈	guizhouyouyuan	gzyy
海鸬鹚	hailuci	hlc
海南虎斑鳽	hainanhubanqian	hnhbq
海南山鹧鸪	hainanshanzhegu	hnszg
海南兔	hainantu	hnt
河麂	heji	hj
河狸	heli	hl
鹤嘴翠鸟	hezuicuiniao	hzcn
黑浮鸥	heifuou	hfo
黑腹沙鸡	heifushaji	hfsj
黑鹳	heiguan	hg
黑鹮	heihuan	hh
黑麂	heiji	hj
黑颈鹤	heijinghe	hjh
黑颈鸬鹚	heijingluci	hjlc
黑颈长尾雉	heijingchangweizhi	hjcwz
黑颏果鸠	heikeguojiu	hkgj
黑脸琵鹭	heilianpilu	hlpl
黑琴鸡	heiqinji	hqj
黑头角雉	heitoujiaozhi	htjz
黑鹇	heixian	hx
黑胸蜂虎	heixiongfenghu	hxfh
黑熊	heixiong	hx
黑长尾雉	heichangweizhi	hcwz
黑嘴端凤头燕鸥	heizuiduanfengtouyanou	hzdftyo
红腹角雉	hongfujiaozhi	hfjz
红胸黑雁	hongxiongheiyan	hxhy
红胸角雉	hongxiongjiaozhi	hxjz
虹雉褐马鸡	hongzhihemaji	hzhmj
胡兀鹫	huwujiu	hwj
虎	hu	h
虎头海雕	hutouhaidiao	hthd
虎纹蛙	huwenwa	hww
花田鸡	huatianji	htj
花尾榛鸡	huaweizhenji	hwzj
荒漠猫	huangmomao	hmm
皇鸠	huangjiu	hj
黄腹角雉	huangfujiaozhi	hfjz
黄喉貂	huanghoudiao	hhd
黄羊	huangyang	hy
黄嘴白鹭	huangzuibailu	hzbl
黄嘴河燕鸥	huangzuiheyanou	hzhyo
灰腹角雉	huifujiaozhi	hfjz
灰鹤	huihe	hh
灰喉针尾雨燕	huihouzhenweiyuyan	hhzwyy
灰燕鸻	huiyanheng	hyh
姬田鸡	jitianji	jtj
鲣鸟	jianniao	jn
角??	jiaopiti	jpt
金雕	jindiao	jd
金猫	jinmao	jm
金丝猴	jinsihou	jsh
锦鸡	jinji	jj
鲸目（除一类外其它鲸类）	jingmu（chuyileiwaiqitajinglei）	jm（cylwqtjl）
巨松鼠	jusongshu	jss
巨蜥	juxi	jx
鹃鸠	juanjiu	jj
孔雀雉	kongquezhi	kqz
阔嘴鸟	kuozuiniao	kzn
蓝耳翠鸟	lanercuiniao	lecn
蓝马鸡	lanmaji	lmj
蓝鹇	lanxian	lx
棱皮龟	lengpigui	lpg
镰翅鸡	lianchiji	lcj
鬣羚	lieling	ll
柳雷鸟	liuleiniao	lln
绿海龟	lvhaigui	lhg
绿喉蜂虎	lvhoufenghu	lhfh
绿鸠	lvjiu	lj
绿孔雀	lvkongque	lkq
马来熊	malaixiong	mlx
马鹿（包括白臀鹿）	malu（baokuobaitunlu）	ml（bkbtl）
蟒	mang	m
梅花鹿	meihualu	mhl
蒙古野驴	mengguyelv	mgyl
猕猴	mihou	mh
麋鹿	milu	ml
拟兀鹫	niwujiu	nwj
扭角羚	niujiaoling	njl
盘羊	panyang	py
坡鹿	polu	pl
普氏原羚	pushiyuanling	psyl
鳍脚目	qijiaomu	qjm
儒艮	rugen	rg
三线闭壳龟	sanxianbikegui	sxbkg
沙丘鹤	shaqiuhe	sqh
山瑞鳖	shanruibie	srb
勺鸡	shaoji	sj
猞猁	sheli	sl
麝(所有种)	she(suoyouzhong)	s(syz)
石貂	shidiao	sd
水鹿	shuilu	sl
水獭	shuita	st
四川山鹧鸪	sichuanshanzhegu	scszg
四爪陆龟	sizhaolugui	szlg
隼科(所有种)	sunke(suoyouzhong)	sk(syz)
蓑羽鹤	suoyuhe	syh
塔尔羊	taeryang	tey
塔里木兔	talimutu	tlmt
台湾猴	taiwanhou	twh
台湾鬣羚	taiwanlieling	twll
太平洋丽龟	taipingyangligui	tpylg
鹈鹕	tihu	th
天鹅	tiane	te
铜翅水雉	tongchishuizhi	tcsz
兔狲	tusun	ts
豚鹿	tunlu	tl
豚尾猴	tunweihou	twh
驼鹿	tuolu	tl
西藏野驴	xizangyelv	xzyl
犀鸟科	xiniaoke	xnk
鼷鹿	xilu	xl
细瘰疣螈	xiluoyouyuan	xlyy
细痣疣螈	xizhiyouyuan	xzyy
细嘴松鸡	xizuisongji	xzsj
鸮形目	xiaoxingmu	xxm
小灵猫	xiaolingmao	xlm
小鸥	xiaoou	xo
小青脚鹬	xiaoqingjiaoyu	xqjy
小杓鹬	xiaoshaoyu	xsy
小苇鳽	xiaoweiqian	xwq
小熊猫	xiaoxiongmao	xxm
小爪水獭	xiaozhaoshuita	xzst
熊猴	xionghou	xh
熊狸	xiongli	xl
雪豹	xuebao	xb
雪鸡	xueji	xj
雪兔	xuetu	xt
血雉	xuezhi	xz
鸦鹃	yajuan	yj
亚洲象	yazhouxiang	yzx
岩雷鸟	yanleiniao	yln
岩鹭	yanlu	yl
岩羊	yanyang	yy
扬子鳄	yangzie	yze
野骆驼	yeluotuo	ylt
野马	yema	ym
野牦牛	yemaoniu	ymn
野牛	yeniu	yn
叶猴	yehou	yh
遗鸥	yiou	yo
鹦鹉科	yingwuke	ywk
鹰科其它鹰类	yingkeqitayinglei	ykqtyl
渔猫	yumao	ym
玉带海雕	yudaihaidiao	ydhd
鸳鸯	yuanyang	yy
原鸡	yuanji	yj
鼋	yuan	y
云豹	yunbao	yb
云南闭壳龟	yunnanbikegui	ynbkg
长臂猿	changbiyuan	cby
长脚秧鸡	changjiaoyangji	cjyj
镇海疣螈	zhenhaiyouyuan	zhyy
雉鹑	zhichun	zc
中华白海豚	zhonghuabaihaitun	zhbht
中华秋沙鸭	zhonghuaqiushaya	zhqsy
朱鹮	zhuhuan	zh
紫貂	zidiao	zd
棕背田鸡	zongbeitianji	zbtj
棕熊(包括马熊)	zongxiong(baokuomaxiong)	zx(bkmx)
